NO textures/Tile/Tile_01-128x128.png
SO textures/Bricks/Bricks_22-128x128.png
WE textures/Wood/Wood_02-128x128.png
EA textures/Grass/Grass_03-128x128.png

F 0,0,100
C 0,100,100

1111111111
1100010001
1000000101
1000000001
1000000011
10000N0001
1100000011
1000000001
1000000111
1100001101
1111111111