NO textures/eagle.png
SO textures/bluestone.png
WE textures/redbrick.png
EA .png

F 153,204,102
C 0,204,245

1111111111
1100000001
111111011
1000010001
1000000101
1000000001
1010000011111111
1000000N0000001
1100000011111111
1000000001
100000001
1100101001
11111111111
