NO textures/redbrick.png
SO textures/greystone.png
WE textures/eagle.png
EA textures/bluestone.png

F 153,204,102
C 0,204,255

     111   111           
111111011111011  
1000010000000001
100000010000011
1000000001111
1010000011111111
10000N0000000001
1100000011111111
1000000001
100000001
1100101001
11111111111