NO textures/redbrick.png
SO textures/greystone.png
WE textures/eagle.png
EA textures/bluestone.png

F 153,204,102
C 0,204,255

1111111111
1100010001
1000000101
1000000001
1010000011111111
10000E0000000001
1100000011111111
1000000001
1000000001
1100101001
1111111111
