NO textures/eagle.png
SO textures/bluestone.png
WE textures/redbrick.png
EA textures/korea_flag.png

F 153,204,102
C 150,200,200

1111111111
1100000001
111111011
1000010001
1000000101
1000000001
101000N011111111
100000000000001
1100000011111111
1000000001
100000001
1100101001
11111111111


