NO textures/Tile/Tile_01-128x128.png
SO textures/Bricks/Bricks_22-128x128.png
WE textures/Wood/Wood_02-128x128.png
EA textures/Grass/Grass_03-128x128.png

F 153,204,102
C 0,204,255

11           
11111111111111
1000010000000001
100000010000011
1000000001111
1010000011111111
10000N0000000001
1100000011111111
1000000001
1000000001
1100101001
1111111111